########
单词本
########


aucimannose: Paucimannose (少甘露糖) 是一种无脊椎动物和植物中常见的甘露糖苷 N-糖表位。 Paucimannose 聚糖在癌症中表达。mannose 是甘露糖. 甘露糖（Mannose）是一种单糖，也是一种六碳糖。在自然界中较少单独存在，多以群体的大分子形式出现。其甜度比蔗糖低，可作为糖尿病患者的代糖使用

glycosylate: 糖基化.

glycosyl: 糖基.

glycol: 乙二醇.

glycogen: 糖原.

glycine: 甘氨酸.

glucose: 葡萄糖.

clostridium: 梭菌, 是细菌的一个纲.

reagent: [c.] 试剂.

amendable: [adj.], amend 的形容词形式.

amend: [v.] 修正, 订正. (make minor changes to something (like text, piece of legislation) to make it more fair or more accurate).

promply: [adv.] 讯速地.

prompt: 除了常见的动词用法 "鼓励/提词/催促" 外, 还有形容词 "准时/迅速" 的含义.

disclaimer: [n.] 免责声明.

specifric: [adj.] 具体的; 特有的; 有特效的; (物理) 成比率的;

hallmark [adj.] 标志.

dromedary [n.] 单峰骆驼.

identity [n.] 身份; 特性; 恒等式. *Subsequently, we substituted the remaining “non-human” residues in the framework and resurfaced NbBcII10 to obtain a humanized Nanobody scaffold (h-NbBcII10FGLA) so as to exhibit the closest possible amino acid identity to a human VH (Fig. 1).*

retention: [v.] 保留, 保持; 潴留.

inception: 开端；开创

propensity: 倾向；习性

a battery of: 一批，一系列

prose: 平淡的；散文式的

rodent: 啮齿目动物

fetus: 胚胎；胚胎的

curated: 仔细挑选并展览的

ribose: 核糖

ribosome: 核糖体

nucleoside: 核苷

nucleotide: 核苷酸

staple: 主要的；分级

exposition: 解释；展览；暴露，揭露

get the hang: 逐渐学会

bother: 费心；打扰

precisely: 正是，恰好

gamates: 配子

recapitulate: 概括，摘要；复述
